+------------------------------+                                                         
|..............................|                                                         
|..............................|                                                         
|..............................|                                                         
|..............................#############      +-------------------------------------+
|..............................|           #      |.....................................|
|..............................|           #      |.....................................|
|..............................|           #      |.....................................|
+---#---------------------#----+           #      |.....................................|
    #                     #                #      |.....................................|
    #                     #                #      |.....................................|
    #######               #                #      |.....................................|
    #                     #                #      |.....................................|
    #                     #                #      +---------#---------+.................|
    #                     #                #                #         |.................|
    #                     #                #                #         |.................|
    #########################################################         |.................|
           #                                                          |.................|
           #                                                          |.................|
           #                                                          |.................|
     +-----#------+                                   #               |.................|
     |............|                                   #               |.................|
     |............|                                   #               |.................|
     |............|                               #####################.................|
     |............|                               #                   |.................|
     +------------+                               #                   +-----------------+
                                                  #                                      
                                                  #                                      
                                                  #                                      
                                                  #                                      
                                         +--------#---------------------+                
                                         |..............................|                
                                         |..............................|                
                                         |..............................|                
                                         |..............................|                
                                         +------------------------------+                
                                                                                         